6 15
23 17
███████████████████████
█      #        █   █T█
█ ███ ███ █████ █ █ █ █
█t█  c  █   cc█ █t█ █ █
███ ███ ███ ███ ███#█ █
█     █ █     A     █ █
█ ███ █ ███ █████ ███ █
█c█t  █ c █ █c #   c█ █
█ █████ █ █ ███#█ ███ █
█       █   █T #█   █ █
█████#███████████ █ █ █
█ccc      █t█t    █ ##█
█████████ █ ███████ ███
█ ## ##   █ █t  █     █
█ █ █ █ █ █ ███ █ █ █ █
█T█c█c█c█    c    █c█t█
███████████████████████


